1111111111
1000000001
1010000011
1011111011
1000100011
1000100011
1111111111
1111111111
1111111111
1111111111