11111111111111111111
10000000001000000001
10111111001011111101
10100001000010000101
10101111101111110101
10100000000000000101
10101111111111110101
10101000000000010101
10101111111111110101
10100000001000000101
11111111001011111111
10000001001010000001
10111111011110111101
10100000000000100101
11101111111110111111
10000000000000000001
10111111111111111101
10000000000000000001
01111111100100000001
11111111111111111111